7, 7
   =  " "  =   
  '  -   -  '  
 '  '     '  ' 
=  "   -   "  =
  '   ' '   '  
 -   "   "   - 
"   '     '   "
   -       -   
"   '     '   "
 -   "   "   - 
  '   ' '   '  
=  "   -   "  =
 '  '     '  ' 
  '  -   -  '  
   =  " "  =   
